111111111111111111111111111111
100010100000000000010001000001
101010101001111101000100010101
101010101111010001111111111101
101010100001010101000000000001
101000111131010101011111111111
101110000111010101000000000001
100000010000000101011110111111
111111011111111101100000000001
100000010001000000001100011111
101111110101011111100111110001
100000000101110000110000000101
111011111100000110100011111101
101110000101110110001000000001
100000111100010111111010101001
101010000101010000001111111101
101010111111111111100000000001
101100000100000000111111111101
101001110101111010000000000001
101101010100001011111111111101
121000010001101000001000000001
111111111111111111111111111111
